999999999999999999999999999999999999999999999999
900000000000000000000000000000000000000000000009
900000000000009999999999999999999990000000000009
999999999900000900000000000000000090000000000009
90000000000000090000000000000000090000100000009
900000000000000900000099000000000090000000000009
900099999999000900000000000000000090000000000009
900000000000000900000000000000000090000000000009
902000000000000900000009999999999990000000000009
900000000000000000000000000000000000000000000009
999999999999999999999999999999999999999999999999
